##   #  
   # # #
##   # #
   # # #
 ###   #