#     ## #######  ########### # #    ## #######  # ######## # 
# ### ##   #             ##   # #### ##   #             ##   # 
# # # #### ############# ## ### ## # #### #### ######## ## ### 
# # #                ### ##  ## ## #                ### ##  ## 
# #  #### ###### ### ### ## ### ##  #### ###### ### ### ## ### 
#### #### ## ### ###   # ##   # ### #### ## ### ###   # ##   # 
###   ### ## ###     # #    # # ##   ### ## ###     # #    # # 
##  # ###    ####### #  ##### # #  # ###    ####### #  ##### # 
#  ## ##  ## ####### ##   ###     ## ##  ## ####### ##   ###   
# ###    ##        # ## ### ## #####    ##        # ## ### ## #
#    # #### #### ###        ## ##   # #### #### ###        ## #
# ##   #    #### ### # # ## ## ####   #    #### ### # # ## ## #
# ###### ##          #   ## ########### ##          #   ## ####
#        ######## #### ##               ######## #### ##     ##
## ## ## ########        #### ### ## ## ########        #### ##
## ##      ###    ## ## ##### ### ##      ###    ## ## ##### ##
#   # ####     # ### ##           # ####     # ### ##         
  #        #####      ######## ##       #####      ######## #
#     #########################      ######################### 
# ###            ##           # ####            ##           # 
#     ## #######  ########### # #    ## #######  ########### # 
# ### ##   #             ##   # #### ##   #             ##   # 
# # # #### ############# ## ### ## # #### ############# ## ### 
# # #                ### ##  ## ## #                ### ##  ## 
# #  #### ###  # ### ### ## ### ##  #### ###### ### ### ## ### 
#### #### ## # # ###   # ##   # ### #### ## ### ###   # ##   # 
###   ### ## # #     # #    # #      ### ## ###     # #    # # 
##  # ###    #    ## #  ##### # #  # ###    ####### #  ##### # 
#  ## ##  ## ####### ##   ###   # ## ##  ## ####### ##   ###   
# ###    ##        # ## ### ## #####    ##        # ## ### ## #
#    # #### #### ###        ## ##   # #### #### ###        ## #
# ##   #    #### ### # # ## ##  ###   #    #### ### # # ## ## #
# ###### ##          #   ## ### ####### ##          #   ## ####
#        ## ##  # #### ##     # #       ## ##### #### ##     ##
## ## ## ##    ##        # ## # # ## ## #     ##        #### ##
## ##      ###    ## ## ## ## # # ##      ###    ## ## ##### ##
#   # ####     # ### ##            # ####     # ### ##         
  #        #####      ######## ##       #####      ######## # 