#     ## #######  ###  #   ###### #####  # ######## #  
# ### ##   #         ####    #      #           ##   # 
# # # #### ########### ## ## ###### ## ######## ## ### 
# # #                # ##                   ### ##  ## 
# #  #### ###### ### #   ## ###### #### ### ### ## ### 
#### #### ## ### ### ### ## ## ### ## # ###   # ##   # 
###   ### ## ###     # #  # ## ### ## #     # #    # # 
##  # ###    #######   ## #    ###    ##### #  ##### # 
#  ## ##  ## #######        ## ##  ## ##### ##   ###   
# ###    ##        # ####  ##     ##      # ## ### ## #
#    # #### #### ###     #### ###### ## ###        ## #
# ##   #    #### ### ###      ###    ## ### # # ## ## #
# ###### ##          ##### ##     ##        #   ## ####
#        ######## ###  #   ###### ###### #### ##     ##
## ## ## ########     ###  ###### ######        #### ##
## ##      ###    ##  ###    ###    ##   ## ## ##### ##
#   # ####     # ###  ## ##     ###    ### ##        # 
  #        #####       #   #####    ##     ######## #  
#     ###############     ############################ 
#    # #### #### ###   # #### ###### ## ###        ## #
# ##   #    #### ### ###      ###    ## ### # # ## ## #
# ###            ##  ####               ##           # 
#     ## #######  ###  #   ###### #####  ########### # 
# ### ##   #         ####    #      #           ##   # 
# # # #### ########### ## ## ###### ########### ## ### 
# # #                # ##                   ### ##  ## 
# #  #### ###  # ### # # ## ###### #### ### ### ## ### 
#### #### ## # # ### ### ## ## ### ## # ###   # ##   # 
###   ### ## # #       #  # ## ### ## #     # #    # # 
##  # ###    #    ##   ## #    ###    ##### #  ##### # 
#  ## ##  ## #######  ###   ## ##  ## ##### ##   ###   
# ###    ##        # ####  ##     ##      # ## ### ## #
#    # #### #### ###     #### ###### ## ###        ## #
# ##   #    #### ### ###      ###    ## ### # # ## ## #
# ###### ##          ##### ##     ##        #   ## ####
#        ## ##  # ###      ## ### ## ### #### ##     ##
## ## ## ##    ##     ###  #      ##  ##        #### ##
## ##      ###    ##  ###    ###    ##   ## ## ##### ##
#   # ####     # ###   ## ##     ##   # ### ##         
  #        #####       #   #####    ##     ######## #  